acquaint = bildirmek, bilgi vermek
acquainted with = ile tanışık
adherent = bağlı
adverse = olumsuz, ters
affordable = ulaşılır, uygun fiyatlı
agitated = telaşlı, galeyana gelmiş
alluring = çekici, alımlı
ambiguous = muğlak, belirsiz
amusing = matrak
annoyed = öfkeli
antagonistic = zıt, karşıt
antecedent  = önce gelen
apparent    = bariz, açık
appealing   = çekici
apprehensive = tedirgin
applicable = uygulanabilir
arable = sürülüp, ekilebilir
arbitrary = keyfi
as to = e dair
ascending = yükselen, artan
assorted = çeşitli
astonishing = şaşırtıcı
at odds with = kavgalı
beligerent = saldırgan
benign = iyi huylu, bereketli
bewildered = şaşkın
bewildering = şaşırtıcı, afallatıcı
biased = önyargılı
buoyant = batmaz, yüzen
catasrophic = feci, felaket
celestial = göksel, semavi
charming = büyüleyici
cogent = ikna edici
cognitive = bilişsel, bilmeye dair
collateral = ikincil, tali
committed to = -e adanmış
communal = halka ait, toplumsal
compatible = uygun, uyumlu
compelling = zorlayıcı
competent = ehil, yetkili
comprehensive = kapsamlı, toplu
compulsory = zorunlu
concerned = endişeli, ilişkili
concerning = alakalı
concise = özlü, az ve öz
conclusive = ikna edici, son, nihai
concrete = somut
conflicting = karşı duran, yüzleşen
conscious = kasten bilincinde
consecutive = ardışık
considerable = hatırı sayılır, hayli fazla
consistent = sürekli, tutarlı
content = hoşnut, memnun
contradicting = çelişen, çelişkili
conratictory = çelişkili, aykırı
contrary = zıt, karşıt
conveniant = uygun, elverişli
convicted = mahkum
convincing = ikna edici
correspondent = denk, tekabul eden
counterfeit = sahte, taklit
credible = güvenilir
creditable = inanılabilir, övülecek kadar iyi
customary = alışılmış, geleneksel
cynical = alaycı, inanmayan, şüpheci
pinning = iğneleme